#########################
#S          #   # #     #
# # ####### # # # ### ###
# # #   #     # #       #
# # # # ############# # #
# #   # #             # #
# ####### # ### ####### #
#   #     # # # # #     #
# # # ##### # # # #######
# # # # # # # # #       #
# ### # # # # ### ##### #
# #     # #     #     # #
# ### ### # ##### ### ###
#       #         #   #E#
#########################