#########
#       #
#       #
#  ###  #
#  #E   #
#  ###  #
#   S   #
#       #
#########
