#######
#     #
# ### #
# #E# #
# ### #
#S    #
#######