#######
#     #
# ### #
# #E  #
# ### #
# S#  #
#######